11111111
10000001
10000P01
10000001
11111111
