11111111
101E0001
10010P01
1C000001
11111111
