11111111
100E0001
10000P01
10000001
11111111