1111111111111111111
1CCCCCCCC1CCCCCCCC1
1C11C111C1C111C11C1
1CCCCCCCCCCCCCCCCC1
1C11C1C11111C1C11C1
1CCCC1CCC1CCC1CCCC1
1111C111010111C1111
1111C100000001C1111
1111C101111101C1111
1000C001000100C0001
1111C101111101C1111
1111C100000001C1111
1111C101111101C1111
1CCCCCCCC1CCCCCCCC1
1C11C111C1C111C11C1
1CC1CCCCCPCCCCC1CC1
11C1C1C11111C1C1C11
1CCCC1CCC1CCC1CCCC1
1C111111C1C111111C1
1CCCCCCCCCCCCCCCCC1
1111111111111111111
