11111111
100E0001
11100P01
1C100001
11111111
