11111111
100E0001
10000P01
1C000001
11111111
